// 75 75
###########################################################################
###########################################################################
###########################################################################
###########################################################################
###########################################################################
###########################################################################
###########################################################################
###########################################################################
###########################################################################
###########################################################################
###########################################################################
###########################################################################
###########################################################################
###########################################################################
###########################################################################
###########################################################################
###########################################################################
###########################################################################
###########################################################################
###########################################################################
###########################################################################
###########################################################################
###########################################################################
###########################################################################
###########################################################################
###########################################################################
########################################################eeeeeee############
########################################################eeeeeee############
########################################################eeeeeee############
#########################################################eeeee#############
###########################################################.###############
###########################################################.###############
###########################################################.###############
##############################################.....BqqqqqW..###############
##############################################.#####qqqqqq#################
##############################################.######qqqqq#################
#############################################..#####qqqqq##################
#########################################......#######W####################
#########################################.############.#$$$$$$$############
######################################~~~~############.#$$$$$$$#^^^^^######
###############################.......~~~~############.#$$$$$$$#^^^^^######
###############################B######~~~~############.#####R###^^^^^######
###############################.#2222###B#############...W%%%%%G^^^^^######
###################wwwwww#..###.G2222##33333###******#####%%%%%############
##################wwwwwww.......#2222G333333W..******W....%%%%%B&&&&&######
###############..Wwwwwwww.#####.######333333###******#####%%%%%#&&&&&######
###############.###############R#----#R###.#################W###&&&&&######
###############.###############.#----#.###.#################.###&&&&&######
###############.############.....-----.##...################.##############
#############((((((R.........####----###.....##########ttt##.##############
############(((((((####################4444444########tttttttt#############
############(((((((####################4444444########tttttttt#############
##########..((((#######################4444444########tttttttt#############
##########.############################4444444#########ttt###W#############
##########...))))))####################4444444###############.#############
#############))))))####################4444444###############.#############
#############))))))####################4444444######yyyyy####.#####iiiii###
##########################################.#########yyyyy#rrrrrr###iiiii###
##########################################.#########yyyyyGrrrrrrR..iiiii###
####################################999##999##999##########rrrrr###########
####################################9999999999999#############rr###########
####################################999##999##999##############B###########
#####################################R####B####G##############uuuuu########
###################################5555##!!!##6666############uuuuu########
###################################5555##!!!##6666############uuuuu########
###################################5555##!!!##6666###77777#################
####################################555#!!!!!#666####77777#################
#####################################...!!!!!...#####77777#################
##########################################.##########77777#####888888######
##########################################.##########B#########888888######
###############################11111####00000####............G8888888######
###############################11111...W00000W.....######R######88888######
####################..#########11111####00000#######@@@@@@@#####88888######
#####################.###################000########@@@@@@@################
###########################################################################
