// 100 50
####################################################################################################
##########))))))####-----W....################################\\\\#######||||#;;;;;###.##:::########
##########))))))))##-----####......###########################\\\\W......||||W;;;;;###.##:::::######
##########))))##W###########..####.###########################\\\\#######||||#;;;;;W....W:::::######
#(((###########&&&#^^^######W#####W###########00000000.#######\\\\R.....######;;;;;###.###::::######
#(((((((##&&&&&&&&#^^^#####%%%%#$$$$$........W00000000.W...#####W######.########R#####.####W########
#(((((((W&&&&&&&&&W^^^....W%%%%#$$$$$#########00000000.###.#####.######................####.########
#(((((###&&&&&&&&&#^^^#####%%%%#$$$$$##########0000000####.......#################.########.########
###############W##################B############0000000##########G#################.#######...#######
##########********##22222#######11111############...##########33333#######44444###.#####qqqqqq######
###########********#22222#######11111#############.###########33333#######44444###.######qqqqqq#####
##############G#####22222#######11111#############.###########33333#######44444###.#####qqqqqq######
##############.#######R###########W###############W#############G###########B#####.######qqqqqq#####
##############...................................................................R.#####qqqqqq######
#######################.###...############.....##...####....###########...##########################
#######################.####.#############.###############W#############.###########################
#######################.####B#############G#####eeeee#####.#############R###########################
#######################W####.#############.#####eeeee###.?.#############.###########################
######################55555#.#######77777#.#####eeeee..###.#88888#######.#99999#####################
######################55555W.#######77777R.#####eeee##.###.B88888#######.G99999#####################
######################55555#.#######77777#.###########.###.#88888#######.#99999#####################
############################.#############..##########W##..#############.###########################
############################.............................................###########################
############################.###....##########B###W###G#####....########.###########################
######################66666#.####.##########@@@@@#.#~~~~~###############.#!!!!!#####################
######################66666G.####.##########@@@@@#.#~~~~~###############.W.!!!!#####################
######################66666######.##########@@@@@#.#~~~~~#################!!!!!#####################
#################################.################.#################################################
#################################.################...###############################################
#################################....#############....##############################################
####################################.#############....##############################################
####################################.##############.################################################
####################################.....................###########################################
####################################.#####.#############.###########################################
####################################.#####.############...##########################################
####################################.#####R####.#######...##########################################
####################################.###gggg##..####wwwwwww#########################################
####################################...Bgggg###....Wwwwwwwwww#######################################
########################################gggg##..####wwwwwwwww#######################################
##########################################G####.#####wwwwwwww#######################################
##########################################......###########.########################################
##########################################################hhh#######################################
##########################################################hhh#######################################
#########################################################hhhh######################################
#########################################################hhhhh######################################
#########################################################hhhhh######################################
########################################################hhhhhhh#####################################
#####################################################.####hhhhhh####################################
#####################################################......#########################################
####################################################################################################
