// 100 50
####################################################################################################
##########))))))####-----W....################################\\\\#######||||#;;;;;###.##:::########
##########))))))))##-----####......###########################\\\\W......||||W;;;;;###.##:::::######
##########))))##W###########..####.###########################\\\\#######||||#;;;;;W....W:::::######
#(((###########&&&#^^^######W#####W###########00000000.#######\\\\R.....######;;;;;###.###::::B.####
#(((((((##&&&&&&&&#^^^#####%%%%#$$$$$........W00000000.W...#####W######.########R#####.####W###.####
#(((((((W&&&&&&&&&W^^^....W%%%%#$$$$$#########00000000.###.#####.######................####.##..####
#(((((###&&&&&&&&&#^^^#####%%%%#$$$$$##########0000000####.......#################.###G####.##.#####
###############W##################B############0000000##########G#################.###.###qqq#B#####
##########********##22222#######11111############...##########33333#######44444###.###.#qqqqqq.#####
###########********#22222#######11111#############.###########33333#######44444###.###.##qqqqqq#####
##############G#####22222#######11111#############.###########33333#######44444###.###G#qqqqqq######
##############.#######R###########W###############W#############G###########B#####.###qq#qqqqqq#####
##############...................................................................R.####qqqqqqq######
#######################.###...############.....##...####....###########...##########################
#######################.####.#############.###############W#############.###########################
#######################.####B#############G#####eeeee#####.#############R###########################
#######################W####.#############.#####eeeee###.?.#############.###########################
######################55555#.#######77777#.#####eeeeeee###.#88888#######.#99999#####################
######################55555G.#######77777R.#####eeeeeee###.B88888#######.G99999#####################
######################55555#.#######77777#.###########.###.#88888#######.#99999#####################
############################.#############..##########W##..#############.###########################
############################.............................................###########################
############################.###....##########B###W###G#####....########.###########################
######################66666#.####.##########@@@@@#.#~~~~~###############.#!!!!!#####################
######################66666W.####.##########@@@@@#.#~~~~~###############.W.!!!!#####################
######################66666######.##########@@@@@#.#~~~~~#################!!!!!#####################
#################################.################.#################################################
#################################.################...###############################################
#################################....#############....##############################################
####################################.#############....##############################################
####################################.##############.################################################
####################################.....................###########################################
####################################.#####.#############.###########################################
####################################.#####.############...##########################################
####################################.#####R####.#######...##########################################
####################################.###gggg##..####wwwwwww#########################################
####################################...Bgggg###....Wwwwwwwwww#######################################
########################################gggg##..####wwwwwwwww#######################################
##########################################G####.#####wwwwwwww#######################################
##########################################......###########.########################################
##########################################################hhh#######################################
##########################################################hhh#######################################
#########################################################hhhh######################################.
#########################################################hhhhh######################################
#########################################################hhhhh######################################
########################################################hhhhhhh#####################################
#####################################################.####hhhhhh####################################
#####################################################......#########################################
####################################################################################################
